2.5, 0, 0, 1
1, 0, 1, -1
1, 1, 1, -1
1, 2, 1, -1
1, 9, 1, -1
3, 10, 1, 0
3, 11, 1, 0
0, 9, 1, -1
3, 10, 1, 0
3, 11, 1, 0
5, 0, 0, 2
1, 12, 2, -1
0, 13, 2, 0
0, 12, 2, 0
1, 3, 2, 0
1, 4, 2, 0
1, 5, 2, 0
1, 6, 2, 0
1, 7, 2, 0
1, 8, 2, 0
1, 3, 2, 0
1, 4, 2, 0
1, 5, 2, 0
1, 6, 2, 0
1, 7, 2, 0
1, 8, 2, 0
1, 3, 2, 0
1, 4, 2, 0
1, 5, 2, 0
1, 6, 2, 0
1, 7, 2, 0
1, 8, 2, 0
0, 12, 2, -1
0, 13, 2, 0
0, 12, 2, 0
1, 3, 2, 0
1, 4, 2, 0
1, 5, 2, 0
1, 6, 2, 0
1, 7, 2, 0
1, 8, 2, 0
1, 3, 2, 0
1, 4, 2, 0
1, 5, 2, 0
1, 6, 2, 0
1, 7, 2, 0
1, 8, 2, 0
1, 3, 2, 0
1, 4, 2, 0
1, 5, 2, 0
1, 6, 2, 0
1, 7, 2, 0
1, 8, 2, 0
0, 12, 2, -1
0, 13, 2, 0
0, 12, 2, 0
1, 3, 2, 0
1, 4, 2, 0
1, 5, 2, 0
1, 6, 2, 0
1, 7, 2, 0
1, 8, 2, 0
1, 3, 2, 0
1, 4, 2, 0
1, 5, 2, 0
1, 6, 2, 0
1, 7, 2, 0
1, 8, 2, 0
1, 3, 2, 0
1, 4, 2, 0
1, 5, 2, 0
1, 6, 2, 0
1, 7, 2, 0
1, 8, 2, 0
5, 0, 0, 3
0, 14, 3, 0
